# VibeCraft skirmish map -- 24x16 tiles
# G = grass, W = water, T = trees, R = rock, M = gold mine
#
# Player 1 starts top-left (cols 1-5, rows 1-5).
# Player 2 starts bottom-right (cols 18-22, rows 10-14).
TTTTTTTTTTTTTTTTTTTTTTTT
TGGGGGGGTTTTTTTTTGGGGGGT
TGGGGGGGTTTTTTTTTGGGGGGT
TGGGGGGGTTTTTTTTTTGGGGGT
TGGGGMGGTTTTTTTTTTGGMGGT
TGGGGGGGTTTTTTTTTGGGGGGT
TGGGGGGGGGGGGGGGGGGGGGGT
TWWWWWWGGGGGGGGGGGWWWWWT
TWWWWWWGGGGGGGGGGGWWWWWT
TGGGGGGGGGGGGGGGGGGGGGGT
TGGGGGGTTTTTTTTTTGGGGGGT
TGGMGGGTTTTTTTTTTTGGMGGT
TGGGGGGTTTTTTTTTTGGGGGGT
TGGGGGGGTTTTTTTTTTGGGGGT
TGGGGGGGTTTTTTTTTTGGGGGT
TTTTTTTTTTTTTTTTTTTTTTTT
